5 3 6 2 7
*** 000 *** 
000 AAA 000 
AAA 000 AAA 
000 AAA *** 
000 *** *** 
///
000 AAA 000 
*** 000 AAA 
*** AAA AAA 
*** AAA AAA 
*** *** *** 
